{
  "board": [
    "333333333333333333333333333333",
    "333333333333333333333333333333",
    "332222222222222222222222222233",
    "332111114111111111111411111233",
    "332111111111111111111221111233",
    "332111222211111111111111111233",
    "332111111411111111122411111233",
    "332111111111112211111111111233",
    "332111111111112211111111111233",
    "332222211111111211111112222233",
    "333333211111112222222112333233",
    "333333211111111111111112333233",
    "333333211121111111111212333233",
    "333333211111112111111212333233",
    "333333211111111211211122333233",
    "333333211111111111111112333233",
    "333333211111111111111112333233",
    "332222211111111111111112222233",
    "332111111111111111111111111233",
    "332111114111112221122211111233",
    "332111222111112121121211111233",
    "332111122111112221122211111233",
    "332111112111111121121211111233",
    "332222211111111121121211111233",
    "333333211111212111111411111233",
    "333333211111112211221111111233",
    "333333211141111111114111111233",
    "333333222222222222222222222233",
    "333333333333333333333333333333",
    "333333333333333333333333333333"
  ],
  "size": [30, 30],
  "tile_size": 150,
  "number_of_players": 3,
  "player_locations": [
    [10, 10],
    [20, 20]
  ]
}
