{
  "board": [
    "1111111111",
    "1111111111",
    "1122112211",
    "1122112211",
    "1111111111",
    "1111221111",
    "1111111111",
    "1122222211",
    "1122222211",
    "1111111111"
  ],
  "size": [10, 10],
  "number_of_players": 2,
  "player_locations": [
    [10, 10],
    [20, 20]
  ]
}